################################################################ 
#                      ||                                      # 
#                      ||                                      # 
#                     ||||                                     # 
#                                                              # 
#                   {      $ $           ||||                   #
#                  ###     ###           ||                    # 
#                      ###          |||| ||                    # 
#   ### $  $                          ||  ||                    #
#       ##8#                    |||| ||  ||   #%%#             # 
#            ###                 ||  ||  ||   #  #      ||||   # 
#                           |||| ||  ||  ||   #  #       ||    # 
#             $ $   (         ||! ||! ||! ||!  #     ( (  ||    #
################################################################ 