# # # # # # # # # # # # # # # # # # # # # # # # # # # # # # # # # # # # # # # # # # # # # # # # # # # # # # # # # # # # # # # # 
#                                              |||                                                                            # 
#                                              |||                                                                            # 
#                                             |||||                                                                           # 
#                                                                                                                             # 
#                                           {      $$                        |||||                                            # 
#                                          ###     ###                        |||                                             # 
#                                              ###                     |||||  |||                                             # 
#    ### $$                                                             |||   |||                                             # 
#        ##8#                                                    |||||  |||   |||           #%%#                              # 
#             ###                                                 |||   |||   |||           #  #            |||||             # 
#                                                         |||||   |||   |||   |||           #  #             |||              # 
#                               $ $      (                 |||  ! ||| ! ||| ! ||| !         #           ( (  |||              # 
# # # # # # # # # # # # # # # # # # # # # # # # # # # # # # # # # # # # # # # # # # # # # # # # # # # # # # # # # # # # # # # # 